This is the first of many Logic Simulations you need to pass in order to move up the Military ranks. You are initially supplied with 50 health, but each turn removes 1 health point. Escape the pit and be wary of Dennis.

Logic Simulation 1
An Interactive Fiction by Chris Casil
Release 1 / Serial number 150419 / Inform 7 build 6L38 (I6/v6.33 lib 6/12N) SD

Lobby
There is a locked door to the South and a locked door to the North, and an opening to a room in the east. You hear snoring to the south.

You can see a South Door, a North Door, a Trumpet, a Letter and Basket (closed) here.

>east
Entrance
dfdf.

You can see a ladder here.

* * *

This is the first of many Logic Simulations you need to pass in order to move up the Military ranks. You are initially supplied with 50 health, but each turn removes 1 health point. Escape the pit and be wary of Dennis.

Logic Simulation 1
An Interactive Fiction by Chris Casil
Release 1 / Serial number 150419 / Inform 7 build 6L38 (I6/v6.33 lib 6/12N) SD

Lobby
There is a locked door to the South and a locked door to the North, and an opening to a room in the east. You hear snoring to the south.

You can see a South Door, a North Door, a Trumpet, a Letter and Basket (closed) here.

>south
Bedroom
Something is sleeping in the bed.

You can see Dennis here.

>north
Lobby
On your way back to camp, you fall into a pit which seems to house some sort of animal. You hear snoring to the south

>east
Entrance
dfdf.

You can see a ladder here.

* * *

>south
Bedroom
Something is sleeping in the bed.

You can see Dennis here.

>x monster
Big and Black.

* * *

>south
Bedroom
Something is sleeping in the bed.

You can see Dennis here.

>x dennis
A dark figure that almost looks human.

I beg your pardon?

I beg your pardon?

* * *

This is the first of many Logic Simulations you need to pass in order to move up the Military ranks. You are initially supplied with 50 health, but each turn removes 1 health point. Escape the pit and be wary of Dennis.

Logic Simulation 1
An Interactive Fiction by Chris Casil
Release 1 / Serial number 150419 / Inform 7 build 6L38 (I6/v6.33 lib 6/12N) SD

Lobby
There is a locked door to the South and a locked door to the North, and an opening to a room in the east. You hear snoring to the south.

You can see a South Door, a North Door, a Trumpet, a Letter and Basket (closed) here.

>north
(first opening the painted green door)
It seems to be locked.

>take key
I wonder what this opens.

>south
Lobby
You can see a glass case (closed), a Letter and a Trumpet here.

>look
Lobby
You can see a glass case (closed), a Letter and a Trumpet here.

>open case with key
You unlock the glass case.

>examine case
You see nothing special about the glass case.

>x letter
I wish I had friends.

>south
Bedroom
You see the cannibal.

You can see Dennis here.

* * *

>north
(first opening the painted green door)
It seems to be locked.

>x doorr
You can't see any such thing.

>x door
The door is nice, but it is locked. Don't you think you should look for a key?

>e
Entrance
.

The only way out is up the ladder.

You can also see a green key here.

>take key
Taken.

>w
Lobby
To the north of the lobby is a green door. There is a person mumbling south of the Lobby.

A painted green door stands in the middle of an old brick wall.

You can also see a glass case (closed), a Letter and a Trumpet here.

>open door with key
You unlock the painted green door.

>open case with key
That doesn't seem to fit the lock.

>n
(first opening the painted green door)

Bathroom
This place is surprisingly clean.

A painted green door stands in the middle of an old brick wall.

You can also see a Silver Key and a Mirror here.

>take ky
You can't see any such thing.

>take key
(the Silver Key)
I wonder what this opens.

>s
Lobby
To the north of the lobby is a green door. There is a person mumbling south of the Lobby.

A painted green door stands in the middle of an old brick wall.

You can also see a glass case (closed), a Letter and a Trumpet here.

>open case
It seems to be locked.

>open case with key
Which do you mean, the Silver Key or the green key?

>oops silver key
"Oops" can only correct a single word.

>open case with silver key
You unlock the glass case.

>take knife
You can't see any such thing.

>x knife
You can't see any such thing.

>l
Lobby
To the north of the lobby is a green door. There is a person mumbling south of the Lobby.

A painted green door stands in the middle of an old brick wall.

You can also see a glass case (closed), a Letter and a Trumpet here.

>open glass case with silver key
That's unlocked at the moment.

>x glass case
You see nothing special about the glass case.

>take knife
You can't see any such thing.

>play trumpet
That's not a verb I recognise.

* * *

This is the first of many Logic Simulations you need to pass in order to move up the Military ranks. You are initially supplied with 50 health, but each turn removes 1 health point. Escape the pit and be wary of Dennis.

Logic Simulation 1
An Interactive Fiction by Chris Casil
Release 1 / Serial number 150419 / Inform 7 build 6L38 (I6/v6.33 lib 6/12N) SD

Lobby
There is a locked door to the South and a locked door to the North, and an opening to a room in the east. You hear snoring to the south.

You can see a South Door, a North Door, a Trumpet, a Letter and Basket (closed) here.

>west
Storage Room
Useless things in here.

You can see a Silver Key and a Trumpet here.

>examine Silver Key
You see nothing special about the Silver Key.

>examine trumpet
You see nothing special about the Trumpet.

* * *

>west
Storage Room
Useless things in here.

You can see a Silver Key and a Trumpet here.

>take trumpet
Taken.

>use trumpety
That's not a verb I recognise.

>use trumpet
That's not a verb I recognise.

>eat trumpet
That's plainly inedible.

* * *

>take trumpet
Taken.

>use trumpet
You must supply a noun.

>eat trumpet
That's plainly inedible.

>use trumpet
You must supply a noun.

>l
Storage Room
Useless things in here.

You can see a Silver Key here.

* * *

>west
Storage Room
Useless things in here.

You can see a Silver Key and a Trumpet here.

>l
Storage Room
Useless things in here.

You can see a Silver Key and a Trumpet here.

>take key
I wonder what this opens.

>open case
It seems to be locked.

* * *

This is the first of many Logic Simulations you need to pass in order to move up the Military ranks. You are initially supplied with 50 health, but each turn removes 1 health point. Escape the pit and be wary of Dennis.

Logic Simulation 1
An Interactive Fiction by Chris Casil
Release 1 / Serial number 150419 / Inform 7 build 6L38 (I6/v6.33 lib 6/12N) SD

Lobby
There is a locked door to the South and a locked door to the North, and an opening to a room in the east. You hear snoring to the south.

You can see a South Door, a North Door, a Trumpet, a Letter and Basket (closed) here.

>w
Storage Room
Useless things in here.

You can see a Silver Key, a glass case (closed) and a Trumpet here.

>take key
I wonder what this opens.

* * *

>open case
It seems to be locked.

>i
You are carrying:
  a Silver Key

>x case
You see nothing special about the glass case.

* * *

>take key
I wonder what this opens.

>use key
I didn't understand that sentence.

>open case
It seems to be locked.

>open case with key
You unlock the glass case.

>x case
You see nothing special about the glass case.

>l
Storage Room
Useless things in here.

You can see a glass case (closed) and a Trumpet here.

>take knife
You can't see any such thing.

* * *

This is the first of many Logic Simulations you need to pass in order to move up the Military ranks. You are initially supplied with 50 health, but each turn removes 1 health point. Escape the pit and be wary of Dennis.

Logic Simulation 1
An Interactive Fiction by Chris Casil
Release 1 / Serial number 150419 / Inform 7 build 6L38 (I6/v6.33 lib 6/12N) SD

Lobby
There is a locked door to the South and a locked door to the North, and an opening to a room in the east. You hear snoring to the south.

You can see a South Door, a North Door, a Trumpet, a Letter and Basket (closed) here.

>s
(first opening the South Door)
It seems to be locked.

>kill dennis
*** Dennis eats you. ***

Would you like to RESTART, RESTORE a saved game, QUIT or UNDO the last command?

>n
Lobby
You can see a Trumpet here.

>play trumpet
That's not a verb I recognise.

>use trumpet
You must supply a noun.

* * *

>eat trumpet
That's plainly inedible.

>w
You can't go that way.

>n
Bathroom
You can see a Silver Key and a Mirror here.

>take key
I wonder what this opens.

* * *

>use key
I didn't understand that sentence.

>s
Lobby
You can see a Trumpet here.

>use key
I didn't understand that sentence.

* * *

>kill dennis
*** Dennis eats you. ***

Would you like to RESTART, RESTORE a saved game, QUIT or UNDO the last command?

>kill dennis with knife
You kill dennis with knife.

>n
Lobby
To the north of the lobby is a green door. There is a person mumbling south of the Lobby.

A painted green door stands in the middle of an old brick wall.

You can also see a glass case (closed), a Silver Key, a Letter and a Trumpet here.

>kill case
Violence isn't the answer to this one.

>s
Bedroom
You see the cannibal.

You can see Dennis here.

>stab dennis with knife
That's not a verb I recognise.

* * *

>kill dennis
*** Dennis eats you. ***

Would you like to RESTART, RESTORE a saved game, QUIT or UNDO the last command?

>restart
As punishment for stealing, you are thrown in a pit that is home to a cannibalistic monster.

The Pit
An Interactive Fiction by Chris Casil
Release 1 / Serial number 150406 / Inform 7 build 6L38 (I6/v6.33 lib 6/12N) SD

Lobby
To the north of the lobby is a green door. There is a person mumbling south of the Lobby.

A painted green door stands in the middle of an old brick wall.

You can also see a Trumpet, a Silver Key, a Letter and Basket (in which is an Arm) here.

>take key
I wonder what this opens.

>open case with key
You unlock the glass case.

>open case
You open the glass case, revealing a knife.

>take knife
Taken.

>s
Bedroom
You see the cannibal.

You can see Dennis here.

>kill dennis
*** Dennis eats you. ***

Would you like to RESTART, RESTORE a saved game, QUIT or UNDO the last command?

* * *

>s
(first opening the South Door)
It seems to be locked.

>talk to dennis
Urgg.

>ask dennis about friends
There is no reply.

* * *

>s
(first opening the South Door)
It seems to be locked.

>attack dennis
Dennis eats you

>n
Lobby
To the north of the lobby is a green door. There is a person mumbling south of the Lobby.

A painted green door stands in the middle of an old brick wall.

You can also see a Trumpet, a Silver Key, a Letter and Basket (in which is an Arm) here.

>take key
I wonder what this opens.

* * *

>s
Bedroom
You see the cannibal.

You can see Dennis here.

>kill dennis with knife
You kill dennis with knife.

>eat dennis
He's plainly inedible.

* * *

>s
(first opening the South Door)
It seems to be locked.

>eat dennis
Dennis gets aroused.

>n
Lobby
To the north of the lobby is a green door. There is a person mumbling south of the Lobby.

A painted green door stands in the middle of an old brick wall.

You can also see a Trumpet, a Silver Key, a Letter and Basket (in which is an Arm) here.